11111111111111111111111111111111111111111111111111111111111111111111111111111
1C01000000000110000C000000011111111111111111111111111111111111111111111111111
1E0C0000000001110000C00000011111111111111111111111111111111111111111111111111
1000000000000110000000C000011111111111111111111111111111111111111111111111111
10000111100001100001111000011111111111111111111111111111111111111111111111111
10000111100001100001111000011111111111111111111111111111111111111111111111111
100001C0000001100000000000011111111111111111111111111111111111111111111111111
1C01000000000110000C000000011111111111111111111111111111111111111111111111111
100C00000000011P000000C000011111111111111111111111111111111111111111111111111
10000111100001100001111000011111111111111111111111111111111111111111111111111
10000111100001100001111000011111111111111111111111111111111111111111111111111
100001C0000000000001C00000011111111111111111111111111111111111111111111111111
1C01000000000110000C000000011111111111111111111111111111111111111111111111111
100C0000000001110000C00000011111111111111111111111111111111111111111111111111
1000000000000110000000C000011111111111111111111111111111111111111111111111111
10000111100001100001111000011111111111111111111111111111111111111111111111111
10000111100001100001111000011111111111111111111111111111111111111111111111111
100001C0000001100000000000011111111111111111111111111111111111111111111111111
1C01000000000110000C000000011111111111111111111111111111111111111111111111111
100C000000000110000000C000011111111111111111111111111111111111111111111111111
10000111100001100001111000011111111111111111111111111111111111111111111111111
1000011110000110000111100000000000C0000000000000C0000000000000000000000000011
11111111111111111111111111111111111111111111111111111111111111111111111111111
11111111111111111111111111111111111111111111111111111111111111111111111111111
11111111111111111111111111111111111111111111111111111111111111111111111111111
11111111111111111111111111111111111111111111111111111111111111111111111111111
11111111111111111111111111111111111111111111111111111111111111111111111111111
11111111111111111111111111111111111111111111111111111111111111111111111111111
11111111111111111111111111111111111111111111111111111111111111111111111111111
11111111111111111111111111111111111111111111111111111111111111111111111111111
11111111111111111111111111111111111111111111111111111111111111111111111111111
11111111111111111111111111111111111111111111111111111111111111111111111111111
11111111111111111111111111111111111111111111111111111111111111111111111111111
11111111111111111111111111111111111111111111111111111111111111111111111111111
11111111111111111111111111111111111111111111111111111111111111111111111111111
11111111111111111111111111111111111111111111111111111111111111111111111111111
11111111111111111111111111111111111111111111111111111111111111111111111111111
11111111111111111111111111111111111111111111111111111111111111111111111111111
11111111111111111111111111111111111111111111111111111111111111111111111111111
11101111111111111111111111111111111111111111111111111111111111111111111111111
11111111111111111111111111111111111111111111111111111111111111111111111111111