11111111111111
100P0000010001
1C010000010001
10000C00000001
1E0C0001000001
110000C0000001
10000000000001
10000000C00001
10000111100001
10000111100001
10000111110001
10000111100001
100001C0000001
11111111111111